14,12
11111111111111
1aaa0000111111
1aaa0000111111
1aaa00000000c1
1aaa00000000c1
10000000000001
10000000000001
11000000111111
11000000111111
11000000111111
11b00000111111
1111X111111111
3
a:{1}[id1;1.0]
b:"That's one dead looking plant!"
c:"These stairs seem a little too challenging for me..."