32,32
11111111111111111111111111111111
10000000000000000001100000000001
10111011111000001111111110111101
10111001111000001111111100111101
101X10011X1000001X100111001X1101
10000000000000000000010000000001
10000000000000000000000000000001
10000000000000000000000000000001
10000000000100000000000000000001
10111101100000001111100000000001
10111101101000001111100011100001
101X1100000000001111100011011111
10000000100110000111110000011111
100000000001100001X1110000011X11
10000011111100000000000000000001
10000011111100000000000000000001
100001111X1100000000000000000001
10000000000000000000000000000001
10000000000000001111111101010001
10000000000000001111111100000111
10000000000000001111111100000111
11111000111100001111111100000001
11111000111100001111111100000001
111X100011110001101X101000000101
10000000011100011000000000000001
1000000001X100000000000000000001
10110000000000000000000000000001
10110000000000001111011000001101
100000100110000011X1011001001101
10001000011000000000000000010001
10000000000000000000000000000001
11111111111111111111111111111111
0